11111111111111111111111111
100000000000C0000000000001
1000010100101101P011000101
10000000000C0001E011000001
10000101111C11C00000000001
11111111111111111111111111
